##---##
#.b.b.#
#.....#
#.a.a.#
#.....#
#.b.b.#
##---##