##---##
#.....#
#.....#
#..a..#
#.....#
#.....#
#######