##---##
#b...b#
#.....#
#..b..#
#.....#
#a...a#
#######