##---##
#.a.b.#
#.....#
#.b.b.#
#.....#
#.b.a.#
##---##