#######
#.....#
#.....#
#..a..#
#.....#
#.....#
#.....#